     ####
     #  #####
    ##@     #
#####   ##  #
# ..# # ## ##
#     $  #$#
##  # #    #
 ####   ##$##
   #######  #
   #.       #
   ##########