AAAA#####
AAAA#   #
AAAA#$  #
AA###  $##
AA#  $ $ #
### # ## #AAA######
#   # ## #####  ..#
# $  $          ..#
##### ### #@##  ..#
AAAA#     #########
AAAA#######