AAAAA####
AAAAA#  #####
AAAA##@     #
#####   ##  #
# ..# # ## ##
#     $  #$#
##  # #    #
A####   ##$##
AAA#######  #
AAA#.       #
AAA##########