########
#@     #
## ##$ #
 # ##  #
 #     #
 # ## ##
 # ## ####
 #      .#
 #########