#######
#     #
#  =  #
#.$@$.#
#  =  #
#     #
#######