AA#####
###   #
#.@$  #
### $.#
#.##$ #
# # . ##
#$ =$$.#
#   .  #
########