#######
#     #
#  =  #
#.$@= #
#  =  #
#     #
#######