#######
#  .  #
#  $  #
#.$@$.#
#  $  #
#  .  #
#######